W W W W W W W W W W W W W W W W W W
W - - - B W B - - B W B - - - - - W
W - P - - - - D B - - - - D - - - W
W - - - - W - - - - W - - - - - - W
W W W W W W W W W W W W W W W W - W
W - - - B B B B B B B B B B - - - W
W - W - - - - - - - - - - - - W W W
W - B W W W W W W W W W W W W W E W
W - - - - - - - - - - - B B B - - W
W - - W D W W W D W - - - - - - - W
W W W W W W W W W W W W W W W W W W