W W W W W W W W W W W W W W W W W W
W - P W - - - - B W B - - - - - - W
W - - W - B - - - W - - B - - D - W
W - - W - - - - D W - - - - - - - W
W - - W - - - - - W - - - - W W W W
W - - B - - - - - B - - - - - B B W
W - - - - - W B - - - - W - - - - W
W - - - - - W - - - - - W - - - - W
W - D - - - W - - - - - W - - E - W
W - - - - - W - - - - - W - - - - W
W W W W W W W W W W W W W W W W W W