W W W W W W W W W W W W W W W W W W
W - - - W B B B W - - - - - - - - W
W - P - W - D - W - - - - - - - - W
W - - - W - - - W - - - - - - - - W
W - - - B - - - B - - - W B B - - W
W - - - - - - - - B B - W - - - - W
W - - - - - - - - - - - W - - - - W
W - B - W - - B B - - - W - - B B W
W - D - W - D - - - - - W - - - - W
W - - - W - - - - - - - W - - - E W
W W W W W W W W W W W W W W W W W W