W W W W W W W W W W W W W W W W W W
W - - - - - - B - - - - - - - B - W
W - P - - - - - - - - - - - - - - W
W W W W W W W B - - - - - - - D - W
W - B - - - - - - - - - - - - - - W
W - D - - - - - - B W W W W W W W W
W - - - - - - - - - - - - - - B - W
W W W W W W W B - - - - - - - - - W
W - - - - - - D - - - - - - - D - W
W - E - - - - - - - - - - - - - - W
W W W W W W W W W W W W W W W W W W