W W W W W W W W W W W W W W W W W W
W - - - B - B - - - B - B - - - - W
W - P - - D - - D - - D - - D - - W
W - - - - - B - - - - B - - - - - W
W - - - - - - B B B B - - - - - - W
W - D - - D - - D - - D - - D - - W
W B B B B B - - - - - - B B B B B W
W - - - - - - - - - - - - - - - - W
W - D - - D - - D - - D - - E - - W
W - - - - - - - - - - - - - - - - W
W W W W W W W W W W W W W W W W W W